NO ./texture/dummy_NO.png
SO 					./texture/dummy_SO.png
WE 			./texture/dummy_WE.png         
EA 	./texture/dummy_EA.png
                                                         
F 220,3,0
C 250,30,0

111111
100101
101001
1100N1
111111

