NO ./texture/dummy_NO.png
SO 					./texture/dummy_SO.png
WE 			./texture/dummy_WE.png         
EA 	./texture/dummy_EA.png
                                                         
F 220,3,0
C 255,0,0

11111  1111111111111
10S01  1000000000011
10001  1000000000001
10001111000111110001
100000000001   10001
100000000001   10001
10000000000111110001
10001111000100010001
10001  1000100010001
10001  100010000000111111
1000111100000000000000001
1000000000000000000100001
1000000000111000000100001
1000000000000000000000001
1111111111000111111111111
       110000011
      11000000011
      10000000001
      11000000011
       111111111
