NO ./texture/wood04_32x32.png
SO ./texture/wood04_32x32.png
WE ./texture/wood04_32x32.png
EA ./texture/wood04_32x32.png

F 105, 73, 52
C 135, 206, 235

1111111
1001001
1010001
1000N01
1000001
1111111
