NO ./texture/dummy_NO.png
SO 					./texture/dummy_SO.png
WE 			./texture/dummy_WE.png                                     
EA 	./texture/dummy_EA.png
                                                         
F 220,30,0
C 225,30,0














11111
10001
10A01
10N01
11111






