NO ./texture/bricks_128x128.png
SO ./texture/bricks02_128x128.png
WE ./texture/bricks03_128x128.png         
EA ./texture/bricks04_128x128.png
                                                         
F 166, 137, 115
C 135, 206, 235

1111111111111111111111111111111
1111111111111111111111111111111
1100000001111111111111000000011
110W000001111111111111000000011
1100000001111111111111000000011
1100000001111111111111000000011
1100000001111100001111000000011
1100000001111100001111000000011
1100000001111100001111000000011
1111101111111110111111011111111
1111100000111110111111011111111
1111101110111110111111011111111
1111100000000000000000011111111
1111111111010000000111111111111
1111111111010011000111111111111
1111111111010011000111111111111
1111111111000000000111111111111
1111111111110000000111111111111
1111111111110000000111111111111
1111111111111101011111111111111
1111111111111101011111111111111
1111111111111101011111111111111
1100000000000001000000000000011
1100000001111111111111000000011
1100110001111011111111000000011
1100110001111011111111000000011
1100000001000011111111000000011
1100000001111111111111000000011
1100000001111111111111000000011
1111111111111111111111111111111
1111111111111111111111111111111
